RRGGBBRRRR
RRRRRRRRRR
GGGGGGGGGG
GGGGGGGGGG
BBBBBBBBBB
BBBBBBBBBB
RRRRRRRRRR
RRRRRRRRRR
GGGGGGGGGG
GGGGGGGGGG
BBBBBBBBBB
BBBBBBBBBB
RRRRRRRRRR
RRRRRRRRRR
GGGGGGGGGG
GGGGGGGGGG
BBBBBBBBBB
BBBBBBBBBB
RRRRRRRRRR
RRRRRRRRRR
